##############################
#          ^^^^              #
#         ^^^^^^             #
#        ^^^^^^^^            #
#  %%%%%%^^^^^^%%%%%%        #
#   ^^^^         ^^^^        #
#   ^^^^         ^^^^        #
#   ^^^^         ^^^^        #
#   ^^^^    #### ####        #
#   ^^^^    #       #        #
#   ^^^^    #       #        #
#  %%%%%%   #       #  %%%%% #
#          #         #       #
#                            #
##############################