##############################
# OOO |                      #
#     |                      #
# |   |                      #
# |   |           ooo        #
#     |                      #
#------                      #
#                            #
#                            #
#    |__|                    #
#                            #
#                            #
#                            #
#                            #
#################-############