##############################
# OOO |                      #
#     |                      #
# |   |                 |    #
# |   |                 |    #
#     |                 |    #
#------                 |    #
#                            #
#                            #
#       OO                   #
#                            #
#                            #
#                            #
#                            #
#################-############