##############################
# OOO |            >         #
#     |           / \        #
# |   |                      #
# |   |                      #
#     |                      #
#------                      #
#                            #
#                            #
#                            #
#             ^              #
#            /o\             #
#            \_/             #
#                            #
#################-############