##############################
#  OOOOOO  |      () ()      #
#          |      |  |       #
# |        |      |  |       #
# |        |                 #
# |        |                 #
# |        |                 #
# |        |                 #
#          |                 #
#-----------                 #
#                            #
#                            #
#                            #
#                            #
#################-############