##############################
#  OOOOOO  |                 #
#          |                 #
# |        |                 #
# |        |                 #
# |        |                 #
# |        |                 #
# |        |                 #
#          |                |#
#-----------                 #
#                            #
#                            #
#                            #
#                            #
#################-############