##############################
# OOO |                |   - #
#     |                |     #
# |   |                |  |  #
# |   |                |     #
#     |                | D . #
#------                |     #
#                      ------#
#                            #
#                            #
#|                           #
#                            #
#                            #
#                            #
#################-############