##############-###############
#                            #
#                            #
#  |-----|                   #
#  |     |                   #
#                            |
#                   OO       #
#                            #
#                            #
|       --------             #
#                            #
#                            #
#                            #
#                            #
##########-###################