#######-######################
#                            #
#                            #
#                            #
#                            #
#        -----------         #
#        |         |         #
#        -----------         #
#                            #
#                            #
#                            #
#                            #
#       -------------        #
#                            #
##############################