##############################
#  O O      - - - -    BB    #
#----------------------------#
#                            #
#        -          -        #
#                            #
#                            #
#                            #
#                            #
#                            #
#        -          -        #
|                            #
#                            #
#                            #
##############################