##############################
#  O O      - - - -          #
#------------------------|   #
#                        |   #
#        -         -     | B #
#                        |   #
#                        | B #
#                        |   #
#                        |   #
#        -         -     |   #
#                        |---#
|                            #
#                           |#
#                            #
##############################