##############################
# OOO |                      #
#     |             ---      #
# |   |              |       #
# |   |                      #
#     |                      #
#------                      #
#                            #
#                 __         #
#                |__|        #
#                            #
#                            #
#                            #
#                            #
#################-############