##############################
# OOO |                      #
#     |                      #
# |   |                      #
# |   |                      #
#     |                      #
#------                      #
#                            #
#                            #
#                            #
#|                           #
#                            #
#                            #
#                            #
#################-############