########################-#####
#              |             #
#              |             #
#   |     /    |             #
#   |          |             #
#   |          |             #
#              |             #
#              O             #
#              |             #
#        OO    |             #
#              |             #
#   .     ^    |             #
#              |             #
#              |             #
##############################